         1     1   
      4  2  1  2  4

  3   x  *  *  *  x
1 1   *  x  x  x  *
1 1   *  x  x  x  *
2 2   *  *  x  *  *
2 2   *  *  x  *  *